50
50
11111111111111111111111111111111111111111111111111
00000000000000000000000000000000000000000000000000
00000000000000000000000000000000000000001100000000
00000011111111111100000000000000000000000000000000
00000000000000000000000000000000111100000000000000
00000000000000000000000011000000000001100000000000
00000000000000000000000000000000000000000000000000
00000000000000000000000000000000000000000000000000
00000000111111111111111100000000000110000100000000
00000000000000000000000000000000000000001000000000
00000000011110000000000000000000000000000000010000
00000000000000000000000011100000000000000000010000
00000000000000000000000000000000000000000000000000
00000000000000000000000000000000000000000000000000
00000000000000000000000000000000000011100000000000
00000000111111111100000000000000000000000000000000
00000000000000000000000000000000000000001000000000
00000000000000000000000110000000000000000010000000
00000000000000000000000000000000000000001000000000
00000000000000000000000000000000000000001000000000
00000000000000000000000000000000000000001000000000
00000000000000000000000000000000000000001000000000
00000000000000000000000000000000000000001000000000
00000000000000000000000000000000000000000000000000
00000000000000000000000000000000000000000000000000
00000000010000000000000000011100000000000000000000
00000000010000000000000000000000000000000000000000
00000000010000000000000000000000000000000110000000
00000000010000000000000000000000000000000000000000
00000000010000000011111111111111111111100000000000
00000000000000000000000000000000000000000000000000
00000000000000000000000000000000000000000110000000
00000000000000000000000011100000000000000000000000
00000000000000000000000000000000000000000000000000
00000000000000000000000000000000000000000000000000
00000000011111111111111111111111100000000000000000
00000000000000000000000000000000000000000000000000
00000000000000000000000000000000000000000000000000
00000000010000000000000000001111000000000000000000
00000000000000000000000000010000000000000000000000
00000000000001000000000010000000000100000000001000
00000000000000000000000000000000000000000000000000
00000000000011100000000000000000000000000111000000
00000000000000000000000000000000000000000000000000
00000000000000000000011100000000000000000000000000
00000000000000000000000000001000000000001100000000
00000000011111111111111111000000000000000000000000
00000000000000000000000000000000001111000000000000
00000000000000000000000000000000000000000000000000
11111111111111111111111111111111111111111111111111
